XXXXXXXXXXXXXXXXXXXXXXXXXXXXXXXX
XXXXXXXXXXXXXXXXXXXXXXXXXXXXXXXX
XXXXXXXXXXXXXXXXXXXXXXXXXXXXXXXX
XXXXXXXXXXXXXXXXXXXXXXXXXXXXXXXX
XIXXXXXXXXXXXXXXXXXXXXXXXXXXXXXX
XBBXXXXXXXXXXXXXXXXXXXXXXXXXXXXX
XXBBXXXXXXXXXXXXXXXXXXXXXXXXXXXX
XXXBBXXXXXXXXXXXXXSSXXXXXXXXXXXX
XXXXBBXXXXXXXXSSXBBBXXXXXXXXXXXX
XXXXXXXXXXXXBBBBXXXXXXXXXXXXXXXX
XXXXXXXXXXXXXXXXXXXXXXXXXXXXXXXX
XXXXXXXSSSSSXXXXXXXXXXXXXXXXXXXX
XXXXXXXXSSSXXXXXXXXXXXXXXXXXXXXX
XXXXXXXXXXXXXXXXXXXXXBBBBXXXXXXX
XXXXXXXXXXXXXXXXXXXXXXXXBXXXVXXX
XXXXXXXXXXXXXXXXXXXXXXXXBSSSBXXX
XXXXXXXXXXXXXXXXXXXXXXXXXXXXXXXX
XXXXXXXXXXXXXXXXXXXXXXXXXXXXXXXX
XXXXXXXXXXXXXXXXXXXXXXXXXXXXXXXX
XXXXXXXXXXXXXXXXXXXXXXXXXXXXXXXX
XXXXXXXXXXXXXXXXXXXXXXXXXXXXXXXX
XXXXXXXXXXXXXXXXXXXXXXXXXXXXXXXX
XXXXXXXXXXXXXXXXXXXXXXXXXXXXXXXX
XXXXXXXXXXXXXXXXXXXXXXXXXXXXXXXX
