XXXXXXXXXXXXXXXXXXXXXXXXXXXXXXXX
XXXXXXXXXXXXXXXXXXXXXXXXXXXXXXXX
XXXXXXXXXXXXXXXXXXXXXXXXXXXXXXXX
XXXXXXXXXXXXXXXXXXXXXXXXXXXXXXXX
XXXXXXXXXXXXXXXXVXXXXXXXXXXXXXXX
XXXXXXXXXXXXXXXXXXXXXXXXXXXXXXXX
XXXXXXXXXXXXXXBBBBBXXXXXXXXXXXXX
XXXXXXXXXXXXXXXXXXXXXXXXXXXXXXXX
XXXXXXXXXXXXXXXXXXXXXXSBXXXXXXBB
XXXXXXXXXXXXXXXXXXXXXXBSXXXXXBBB
XXXXXXXXXXXXXXXXXXXXXXXXXXXXBBBB
XXXXXXXXXXXXXXBBBXXXXXXXXXXBBBBB
XXXXXXXXXXXXXXXXXXXXXXXXXXBBBBBB
XXXXXXXXXXXXXXXXXXXXXXXXXXXXBBBB
XXXXXXXXXSSSSXXXXXXXXXXXXXXXBBBB
XXXXXXXXXXXXXXXXXXXXSSSSSXXXBSSB
XXXXXXXXXXXXXXXXXXXXXXXXXXXXBSSB
XXXXXXBBXXXXXXXXXXXXXXXXXXXXBSSB
XXXXXXXXXXXXXXXXXXXXXXXXXXXXBBBB
XXXXXXXXXSSXXXXXXXXXXXXXXXXXBBBB
XXXXXXXXXXXXXXXIXXXXXXXXXXXXBVBB
XXXXXXXXXXXXXXXXXXXXXXXXXXXXXXXX
XXXXXXXXXXXXBBBBBBXXXXXXXXXXXXXX
SSSSSSSSSSSSXXXXXXSSSSSSSSSSSSSS
